-----*----------
-----B----g-----
-----b----#-----
-----b----------
-----@@---k--X--
-----QQ---#-----
------22--------
---[]-11--K---F-
---[]-DD--#---X-
--MXX-SS--------
--X---UU--r---Y-
---TT-CC--#--XXX
---XX-LL------y-
---XX-XX--%--XXX
---tt-oo--|---G-
---tt-oo--|--XXX